# A # # # # # # # # # # # # # # # # # # # # # # # # # # # #
#   #   #           #               #               #      
#   #   #   #   #   # # # # #   #   #   # # # # #   #   #  
#   #   #   #   #           #   #       #       #       #  
#   #   #   #   # # # # #   # # # # #   #   #   # # # # #  
#   #   #   #       #               #       #           #  
#   #   #   # # #   # # # # # # #   # # # # # # #   # # #  
#   #           #       #           #               #      
#   # # # # # # # # #   #   # # # # # # # # # # # # #   #  
#   #                   #       #               #       #  
#   #   # # # # # # # # # # #   #   # # # # #   #   # # #  
#   #       #           #       #       #           #      
#   # # #   #   #   # # #   # # #   #   # # # # # # #   # #
#   #       #   #   #       #       #           #       #  
#   #   # # #   #   #   # # # # # # # # #   #   #   # # #  
#   #   #       #   #   #               #   #   #          
#   #   #   # # #   #   # # #   # # #   # # #   # # # # # #
#   #   #       #   #       #       #       #              
#   #   # # #   #   # # #   # # #   # # #   # # # # #   #  
#   #   #       #       #   #       #       #       #   #  
#   #   # # # # #   #   #   #   # # #   # # #   #   # # #  
#   #   #           #   #   #       #           #          
#   #   #   # # # # # # #   # # #   # # # # # # # # # # #  
#   #   #               #           #   #                  
#   #   #   # # # # #   # # # # # # #   #   # # # # # # # #
#       #   #   #       #               #   #   #          
# # # # #   #   #   # # #   # # # # #   #   #   #   # # #  
#       #       #   #       #       #   #   #       #      
#   #   # # #   #   #   # # #   #   #   #   # # # # #   #  
#   #           #               #   #                   # B
