# # # # # # # # # # # # # # # # # # # # # #   # # # # # A #
                      # # # # # # # # # # #   # # # # #   #
# # #   # # # # # #                       #           #   #
# # #   #         # #   # #   # # # # #   #   # # #   #   #
# # #   #   # #   # #   # #   # # # # #   #   # # #   #   #
# # #       # # # # #   #           # # # #   # # # # #   #
# # # # #   # #   # #   # # # # #   # # # #         #     #
# # # # #   #             # # # #             # #   #   # #
# #         #   # # # #           # # # # # # # # # #   #  
# #   # # # #         #   # # # # # # # # # # # #   #      
# #   # # # # #   #   #   # #                       #   #  
# #               #       # #   # # # # # # # #   # #   # #
# #   # # # # # # # # # # # #   # # # # # # # #   # #     #
# #   # #       # # #   # # #   #                 # # #   #
# #   # #   #   # # #   # # #   #   # # # # # #   # #     #
# #   # #   #                   #   # #           # #   # #
# #   # #   # # # #   # # # # # #   # #   # # # # # #   #  
# #   # #   # # # #   # # # # # #   # #   # # # # # #      
# #   # #                       #   # #   #             # #
# #   # # # # # # #   # # # # # # # # #   # # # # # #      
# #           # # #   # # # #   # #       # # # # # #   # #
# # # # # #                     #     #                 # #
# # # # # # # # # #   # # # #   #   # # # # # # # # # # # #
# # # # # # # # # # # # # # #   #               # # # # # #
# #                 # # # # #   #   # # # #   # # # # #    
# #   # #   # # #   # # # # #   #   # # # #           #   #
# #   # #   # # #                 #   # # #   # #   # #   #
#     # #   # # # # # # # # # # # #   #       # #         #
# # # # #   # # # # # # # # # # # #   # # #   # #   #   # #
B           # # # # # # # # # # # #     # # # # # # #   # #